
        ##########      ####################
        #############         #########   ########
    #################
        ##### ############       #############
        ########        ###############
    ###$#####################
        ##############################
        ########          ######################
        ################   ##############
        ###         ###########################
        #################                #
        ###############   ###########   ####    
        ####        ########            ##################
        #######################    #######
        #######     #############          ##########
        ##########      ####################
